####################
##       #         #
#@# #### # ####### #
#      #   #     ###
## ## ###### ### ###
#  ## #      # # ###
##### ## #####   ###
#      # ##  # # ###
# ######    #### ###
# # #    ####    ###
#     ####  # ######
# ##### # # #     ##
##### #       ### ##
#     # #########  #
# ##### #       ## #
#     # #### ## ####
# ### #      ##   ##
# # # ######### # ##
# #             # ##
# ##################